11111111111111111111111111
12000000000000000000000001
10000000010000000000000001
11000000100000000000000101
10000000000000000100000001
10000000000000000000000001
10000000000000000000000001
10000000000000000000000001
10000000000000000000000001
10000000000000000000000001
10000000000000000000000001
10000000000000000000000001
10000000000000000000000001
10000000000000000000000001
10000000000000000000000001
10000000000000000000000001
10000000000000000000000001
10000000000000000000000001
10000000000000000000000001
10000000000000000000000001
10000000000000000000000001
10000000000000000000000001
10100000000000000000000001
11000000000000000000001001
13000000100000000000000001
11111111111111111111111111